111111111
1000000P1
100000001
1C00000E1
111111111
111111110